SOKOBAN
10,10
2222222222
2111111112
2111114112
2111111112
2122222222
2131111152
2122222222
2111111112
2111111112
2222222222